Symbol, LatestOI, PrevOI, OIChange, %OIChange, Volume
ACC,10487,7690,2797,36.37,18364
ADANIENT,9555,9465,90,0.95,3641
ADANIPORTS,8278,8353,-75,-0.90,3702
ADANIPOWER,8004,8140,-136,-1.67,4354
AMARAJABAT,2834,2837,-3,-0.11,1552
AMBUJACEM,9705,9098,607,6.67,4927
APOLLOHOSP,4564,4539,25,0.55,3960
APOLLOTYRE,5854,5637,217,3.85,3610
ARVIND,2931,2929,2,0.07,1071
ASHOKLEY,25210,22173,3037,13.70,21695
ASIANPAINT,12995,12390,605,4.88,6012
AUROPHARMA,24007,24317,-310,-1.27,14842
AXISBANK,58381,54570,3811,6.98,37933
BAJAJ-AUTO,13126,12375,751,6.07,7374
BAJAJFINSV,8972,8917,55,0.62,3266
BAJFINANCE,36562,36528,34,0.09,27997
BALKRISIND,3243,3305,-62,-1.88,1691
BANKBARODA,18146,16508,1638,9.92,18699
BANKINDIA,8171,7769,402,5.17,5484
BANKNIFTY,991727,789583,202144,25.60,21189105
BATAINDIA,5843,5649,194,3.43,5894
BEL,7626,6643,983,14.80,9248
BERGEPAINT,1081,1116,-35,-3.14,430
BHARATFIN,3411,3411,0,0.00,0
BHARATFORG,8267,7522,745,9.90,7388
BHARTIARTL,20932,21009,-77,-0.37,7158
BHEL,10547,10981,-434,-3.95,3276
BIOCON,8482,8847,-365,-4.13,3977
BOSCHLTD,5380,5242,138,2.63,654
BPCL,10808,10806,2,0.02,5331
BRITANNIA,13426,13072,354,2.71,5891
BSOFT,824,830,-6,-0.72,343
CADILAHC,11587,11437,150,1.31,3417
CANBK,8367,7770,597,7.68,12072
CASTROLIND,3203,3101,102,3.29,1204
CENTURYTEX,8792,8797,-5,-0.06,3295
CESC,1465,1503,-38,-2.53,536
CHOLAFIN,1493,1411,82,5.81,1137
CIPLA,12746,12556,190,1.51,3531
COALINDIA,23333,20965,2368,11.30,18417
COLPAL,4832,4185,647,15.46,22121
CONCOR,1919,1785,134,7.51,861
CUMMINSIND,3408,3396,12,0.35,740
DABUR,13756,13054,702,5.38,8435
DHFL,10315,10757,-442,-4.11,2329
DISHTV,9820,9825,-5,-0.05,5233
DIVISLAB,8125,8002,123,1.54,3737
DLF,19899,20130,-231,-1.15,14595
DRREDDY,15935,15919,16,0.10,5021
EICHERMOT,21399,21139,260,1.23,7990
ENGINERSIN,3053,2964,89,3.00,1087
EQUITAS,3926,3865,61,1.58,2616
ESCORTS,9432,9337,95,1.02,6655
EXIDEIND,4412,4101,311,7.58,2948
FEDERALBNK,13666,13120,546,4.16,17257
GAIL,10618,10858,-240,-2.21,3573
GLENMARK,8836,8825,11,0.12,3019
GMRINFRA,5171,5076,95,1.87,989
GODREJCP,8316,8447,-131,-1.55,2250
GRASIM,18387,18300,87,0.48,3145
HAVELLS,8048,8059,-11,-0.14,3521
HCLTECH,17173,16680,493,2.96,4475
HDFC,64497,60503,3994,6.60,40699
HDFCBANK,82589,81440,1149,1.41,49257
HEROMOTOCO,18191,17242,949,5.50,14197
HEXAWARE,1802,1850,-48,-2.59,1652
HINDALCO,13294,13444,-150,-1.12,6763
HINDPETRO,10264,10213,51,0.50,4454
HINDUNILVR,42148,41383,765,1.85,13804
HINDZINC,2745,2688,57,2.12,475
IBULHSGFIN,35741,36110,-369,-1.02,30385
ICICIBANK,80065,78485,1580,2.01,32109
ICICIPRULI,4768,4802,-34,-0.71,1706
IDBI,3329,3352,-23,-0.69,53
IDEA,18155,17538,617,3.52,4154
IDFCFIRSTB,15271,14096,1175,8.34,4412
IGL,2261,2275,-14,-0.62,1055
INDIGO,16352,15909,443,2.78,17644
INDUSINDBK,48708,48323,385,0.80,38660
INFRATEL,4066,3952,114,2.88,882
INFY,74144,74761,-617,-0.83,39132
IOC,18049,17001,1048,6.16,8125
ITC,51094,52537,-1443,-2.75,11466
JINDALSTEL,16699,16189,510,3.15,7295
JSWSTEEL,28808,28680,128,0.45,6565
JUBLFOOD,8069,7836,233,2.97,7553
JUSTDIAL,4565,4656,-91,-1.95,4823
KAJARIACER,2622,2236,386,17.26,4153
KOTAKBANK,31973,31026,947,3.05,19060
LICHSGFIN,11337,11413,-76,-0.67,5441
LT,55053,53003,2050,3.87,23915
L&TFH,11644,10963,681,6.21,9743
LUPIN,15482,15338,144,0.94,5134
MANAPPURAM,3235,3245,-10,-0.31,2663
MARICO,3609,3417,192,5.62,938
MARUTI,74272,69115,5157,7.46,101196
MCDOWELL-N,11045,10329,716,6.93,7800
MCX,3898,3761,137,3.64,4516
MFSL,2652,2626,26,0.99,832
MGL,2030,2051,-21,-1.02,519
MINDTREE,7614,4800,2814,58.62,53466
M&M,27172,25869,1303,5.04,12397
M&MFIN,11915,11714,201,1.72,2793
MOTHERSUMI,10124,10158,-34,-0.33,3680
MRF,2996,2846,150,5.27,697
MUTHOOTFIN,2638,2678,-40,-1.49,939
NATIONALUM,5898,5568,330,5.93,1975
NBCC,6086,5926,160,2.70,3459
NCC,8567,8259,308,3.73,4608
NESTLEIND,7579,7741,-162,-2.09,1156
NIFTY,1614600,1501759,112841,7.51,6138892
NIFTYIT,347,358,-11,-3.07,88
NIITTECH,3260,3295,-35,-1.06,1671
NMDC,6902,6684,218,3.26,3403
NTPC,23980,21330,2650,12.42,14183
OFSS,1846,1823,23,1.26,288
OIL,3304,2771,533,19.23,2651
ONGC,21543,18956,2587,13.65,16312
PAGEIND,7891,7689,202,2.63,1195
PEL,15121,14728,393,2.67,8226
PETRONET,7108,7002,106,1.51,3038
PFC,10819,10490,329,3.14,9074
PIDILITIND,5939,5893,46,0.78,2414
PNB,23775,23303,472,2.03,12969
POWERGRID,10298,10037,261,2.60,2143
PVR,2886,2808,78,2.78,1471
RAMCOCEM,1369,1416,-47,-3.32,300
RAYMOND,4151,4130,21,0.51,1665
RBLBANK,11753,11157,596,5.34,12187
RECLTD,13155,13844,-689,-4.98,12619
RELCAPITAL,7690,7872,-182,-2.31,813
RELIANCE,119391,113982,5409,4.75,68911
RELINFRA,7184,7295,-111,-1.52,947
SAIL,13319,12374,945,7.64,6652
SBIN,41688,42404,-716,-1.69,60818
SHREECEM,2662,2666,-4,-0.15,461
SIEMENS,3567,3584,-17,-0.47,1736
SRF,6316,6233,83,1.33,6442
SRTRANSFIN,8726,8677,49,0.56,3199
STAR,4426,4675,-249,-5.33,2115
SUNPHARMA,62860,63625,-765,-1.20,19902
SUNTV,9598,9363,235,2.51,5246
TATACHEM,3545,3573,-28,-0.78,1368
TATAELXSI,10113,12319,-2206,-17.91,6094
TATAGLOBAL,4157,4284,-127,-2.96,1687
TATAMOTORS,37587,36006,1581,4.39,35224
TATAMTRDVR,6095,6075,20,0.33,1751
TATAPOWER,8019,7751,268,3.46,2780
TATASTEEL,48047,46418,1629,3.51,30038
TCS,96272,90181,6091,6.75,60850
TECHM,20152,20267,-115,-0.57,7799
TITAN,23827,23431,396,1.69,35220
TORNTPHARM,1934,1863,71,3.81,3393
TORNTPOWER,2315,2353,-38,-1.61,1392
TVSMOTOR,9479,9245,234,2.53,4109
UBL,2133,2147,-14,-0.65,978
UJJIVAN,5614,5287,327,6.18,3327
ULTRACEMCO,13478,13307,171,1.29,3073
UNIONBANK,6460,6268,192,3.06,3607
UPL,23049,23677,-628,-2.65,14690
VEDL,26953,25679,1274,4.96,11215
VOLTAS,5949,5690,259,4.55,3139
WIPRO,19722,20983,-1261,-6.01,44463
YESBANK,136253,120213,16040,13.34,290661
ZEEL,25241,25141,100,0.40,20609
