Symbol, LatestOI, PrevOI, OIChange, %OIChange, Volume
ACC,5774,5828,-54,-0.93,5754
ADANIENT,12886,13507,-621,-4.60,6604
ADANIPORTS,13030,12379,651,5.26,25022
ADANIPOWER,9525,8288,1237,14.93,9954
AJANTPHARM,1768,1645,123,7.48,1655
ALBK,2343,2173,170,7.82,1719
AMARAJABAT,2213,2411,-198,-8.21,1903
AMBUJACEM,7727,7670,57,0.74,5421
APOLLOHOSP,2676,2573,103,4.00,2197
APOLLOTYRE,4632,4888,-256,-5.24,3657
ARVIND,6819,6923,-104,-1.50,4283
ASHOKLEY,37343,37228,115,0.31,30545
ASIANPAINT,17023,18437,-1414,-7.67,12080
AUROPHARMA,23371,23261,110,0.47,21727
AXISBANK,41047,41293,-246,-0.60,45328
BAJAJ-AUTO,12909,11918,991,8.32,11231
BAJAJFINSV,6099,5906,193,3.27,5213
BAJFINANCE,37467,35385,2082,5.88,58286
BALKRISIND,4587,4608,-21,-0.46,2529
BANKBARODA,23212,22852,360,1.58,18066
BANKINDIA,7838,7256,582,8.02,12724
BANKNIFTY,805370,719489,85881,11.94,7630412
BATAINDIA,5219,5420,-201,-3.71,6669
BEL,9061,9486,-425,-4.48,4314
BEML,3548,3884,-336,-8.65,3746
BERGEPAINT,2980,2769,211,7.62,1656
BHARATFIN,9229,9420,-191,-2.03,8093
BHARATFORG,14338,14444,-106,-0.73,9760
BHARTIARTL,26273,26274,-1,-0.00,15069
BHEL,9758,9218,540,5.86,5553
BIOCON,10157,11017,-860,-7.81,11735
BOSCHLTD,5701,5686,15,0.26,2071
BPCL,7133,6970,163,2.34,5780
BRITANNIA,15349,15443,-94,-0.61,8075
CADILAHC,6295,6194,101,1.63,6746
CANBK,9949,8497,1452,17.09,36888
CANFINHOME,2985,3347,-362,-10.82,2063
CAPF,926,926,0,0.00,0
CASTROLIND,2700,2757,-57,-2.07,1723
CEATLTD,3685,3570,115,3.22,6288
CENTURYTEX,9065,8695,370,4.26,14953
CESC,3114,3200,-86,-2.69,2433
CGPOWER,4508,4452,56,1.26,2412
CHENNPETRO,1196,1108,88,7.94,1253
CHOLAFIN,2442,2441,1,0.04,1191
CIPLA,11531,10890,641,5.89,9674
COALINDIA,15981,16458,-477,-2.90,9229
COLPAL,3161,3101,60,1.93,2787
CONCOR,2389,2143,246,11.48,1343
CUMMINSIND,2696,2740,-44,-1.61,1446
DABUR,12756,12591,165,1.31,10030
DALMIABHA,55,55,0,0.00,0
DCBBANK,1556,1640,-84,-5.12,2293
DHFL,23068,18643,4425,23.74,48243
DISHTV,15423,13068,2355,18.02,38901
DIVISLAB,9684,9500,184,1.94,3610
DLF,15337,14845,492,3.31,23136
DRREDDY,20781,20583,198,0.96,13465
EICHERMOT,23408,23998,-590,-2.46,13308
ENGINERSIN,2872,2877,-5,-0.17,1575
EQUITAS,3799,3818,-19,-0.50,2154
ESCORTS,7439,6110,1329,21.75,36045
EXIDEIND,5746,5578,168,3.01,4902
FEDERALBNK,14084,13965,119,0.85,7738
GAIL,6489,6442,47,0.73,4014
GLENMARK,5083,5105,-22,-0.43,3511
GMRINFRA,5117,5153,-36,-0.70,2888
GODFRYPHLP,975,1027,-52,-5.06,688
GODREJCP,8727,8734,-7,-0.08,4256
GODREJIND,1112,1103,9,0.82,980
GRASIM,16924,16460,464,2.82,9919
GSFC,3954,4111,-157,-3.82,2269
HAVELLS,7145,7457,-312,-4.18,7277
HCLTECH,16882,16294,588,3.61,16212
HDFC,60752,59860,892,1.49,32790
HDFCBANK,65808,72115,-6307,-8.75,61820
HEROMOTOCO,17172,16070,1102,6.86,15200
HEXAWARE,2595,2628,-33,-1.26,1541
HINDALCO,18273,17872,401,2.24,13262
HINDPETRO,10123,10020,103,1.03,4629
HINDUNILVR,23468,23899,-431,-1.80,13747
HINDZINC,2707,2982,-275,-9.22,1840
IBULHSGFIN,31561,30931,630,2.04,35751
ICICIBANK,60789,59243,1546,2.61,86941
ICICIPRULI,7895,8124,-229,-2.82,4677
IDBI,5479,5838,-359,-6.15,3957
IDEA,18179,18125,54,0.30,18646
IDFC,8930,8742,188,2.15,4671
IDFCBANK,17978,17978,0,0.00,0
IDFCFIRSTB,17752,18522,-770,-4.16,11635
IFCI,2142,2173,-31,-1.43,561
IGL,1845,1778,67,3.77,1832
INDIACEM,7403,8485,-1082,-12.75,6638
INDIANB,2800,3169,-369,-11.64,6447
INDIGO,7940,8601,-661,-7.69,8541
INDUSINDBK,39770,40794,-1024,-2.51,38973
INFIBEAM,5612,5416,196,3.62,3397
INFRATEL,5924,5762,162,2.81,7968
INFY,49851,49966,-115,-0.23,34728
IOC,15973,15868,105,0.66,5172
IRB,2934,2999,-65,-2.17,2376
ITC,54478,55755,-1277,-2.29,32457
JETAIRWAYS,3852,4097,-245,-5.98,1970
JINDALSTEL,18961,18399,562,3.05,20773
JISLJALEQS,5874,6050,-176,-2.91,1437
JPASSOCIAT,2957,2861,96,3.36,1070
JSWSTEEL,39165,39142,23,0.06,19588
JUBLFOOD,12406,12456,-50,-0.40,9058
JUSTDIAL,3435,3518,-83,-2.36,3621
KAJARIACER,2688,2636,52,1.97,1895
KOTAKBANK,20984,24716,-3732,-15.10,27095
KPIT,5411,5760,-349,-6.06,4983
KSCL,1220,1243,-23,-1.85,710
KTKBANK,4389,4442,-53,-1.19,2423
LICHSGFIN,11545,11468,77,0.67,9916
LT,52229,51900,329,0.63,92885
L&TFH,9860,9944,-84,-0.84,15139
LUPIN,15486,15282,204,1.33,16852
MANAPPURAM,2243,2193,50,2.28,1969
MARICO,3196,3271,-75,-2.29,1124
MARUTI,80562,79147,1415,1.79,166922
MCDOWELL-N,13028,13429,-401,-2.99,8977
MCX,4362,4563,-201,-4.40,1701
MFSL,2271,2200,71,3.23,2362
MGL,1341,1354,-13,-0.96,828
MINDTREE,8900,9556,-656,-6.86,14810
M&M,28248,29013,-765,-2.64,22465
M&MFIN,11158,11727,-569,-4.85,11346
MOTHERSUMI,11110,11086,24,0.22,9953
MRF,2760,2719,41,1.51,1492
MRPL,1017,1069,-52,-4.86,590
MUTHOOTFIN,2117,2273,-156,-6.86,3475
NATIONALUM,4152,4082,70,1.71,2011
NBCC,6747,6974,-227,-3.25,2752
NCC,8325,8544,-219,-2.56,8123
NESTLEIND,6378,6493,-115,-1.77,3644
NHPC,1029,1027,2,0.19,301
NIFTY,1902207,1829295,72912,3.99,3993987
NIFTYIT,443,406,37,9.11,339
NIITTECH,4006,4187,-181,-4.32,3992
NMDC,6484,6397,87,1.36,2638
NTPC,12145,12162,-17,-0.14,4264
OFSS,990,1002,-12,-1.20,433
OIL,2337,2351,-14,-0.60,1263
ONGC,14663,14294,369,2.58,5250
ORIENTBANK,2540,2545,-5,-0.20,2608
PAGEIND,10332,10114,218,2.16,4793
PCJEWELLER,3576,3813,-237,-6.22,2835
PEL,12015,10020,1995,19.91,20933
PETRONET,5254,4982,272,5.46,5993
PFC,8185,8108,77,0.95,5324
PIDILITIND,6164,6000,164,2.73,4123
PNB,22382,22307,75,0.34,16981
POWERGRID,6131,6355,-224,-3.52,3274
PTC,782,876,-94,-10.73,700
PVR,5420,5495,-75,-1.36,3593
RAMCOCEM,1261,930,331,35.59,1268
RAYMOND,6299,6534,-235,-3.60,6380
RBLBANK,7074,6332,742,11.72,14403
RCOM,5381,5584,-203,-3.64,3864
RECLTD,8890,9192,-302,-3.29,5948
RELCAPITAL,12335,12399,-64,-0.52,19033
RELIANCE,149892,154834,-4942,-3.19,181567
RELINFRA,14181,13578,603,4.44,19879
REPCOHOME,1001,1139,-138,-12.12,1224
RPOWER,3997,4467,-470,-10.52,4121
SAIL,13154,13099,55,0.42,9117
SBIN,44601,44002,599,1.36,52781
SHREECEM,1910,1857,53,2.85,1886
SIEMENS,3798,3851,-53,-1.38,2182
SOUTHBANK,7026,7018,8,0.11,2419
SREINFRA,2333,2406,-73,-3.03,2272
SRF,2093,2219,-126,-5.68,2717
SRTRANSFIN,9776,9119,657,7.20,15511
STAR,5202,5394,-192,-3.56,3666
SUNPHARMA,74354,75483,-1129,-1.50,37981
SUNTV,12411,12870,-459,-3.57,21971
SUZLON,5199,5113,86,1.68,1064
SYNDIBANK,2287,2349,-62,-2.64,1621
TATACHEM,4277,4029,248,6.16,1865
TATACOMM,2901,2798,103,3.68,2690
TATAELXSI,7564,7890,-326,-4.13,6646
TATAGLOBAL,5427,5735,-308,-5.37,3314
TATAMOTORS,49935,50294,-359,-0.71,39070
TATAMTRDVR,9538,9356,182,1.95,4490
TATAPOWER,6460,6392,68,1.06,4081
TATASTEEL,60806,60999,-193,-0.32,50120
TCS,94370,95740,-1370,-1.43,63543
TECHM,11970,11899,71,0.60,11180
TITAN,22011,22281,-270,-1.21,20915
TORNTPHARM,1464,1434,30,2.09,909
TORNTPOWER,1122,1162,-40,-3.44,689
TV18BRDCST,5878,5964,-86,-1.44,3998
TVSMOTOR,9256,9920,-664,-6.69,16070
UBL,3983,4075,-92,-2.26,2852
UJJIVAN,4875,5123,-248,-4.84,5910
ULTRACEMCO,16082,15139,943,6.23,19037
UNIONBANK,7538,8506,-968,-11.38,7408
UPL,16158,16426,-268,-1.63,11440
VEDL,24175,23736,439,1.85,12878
VGUARD,1244,1265,-21,-1.66,877
VOLTAS,6901,6746,155,2.30,7386
WIPRO,17753,17991,-238,-1.32,16116
WOCKPHARMA,5688,5634,54,0.96,11279
YESBANK,137682,140607,-2925,-2.08,178900
ZEEL,36981,33551,3430,10.22,191264
